ama	madre	f
alaba	hija	f
emazte	mujer	f
arreba	hermana	f
ahizpa	hermana	f
izeba	tía	f
amona	abuela	f
emaztegai	prometida	f
alabaorde	hijastra	f
arrebaorde	hermanastra	f
aita	padre	m
seme	hijo	m
senar	marido	m
anaia	hermano	m
neba	hermano	m
osaba	tío	m
mutil	novio	m
aitaorde	padrastro	m
anaiorde	hermanastro	m
nebaorde	hermanastro	m
