María	f
Ana	f
Amaia	f
Maite	f
Ainhoa	f
Maria	f
Miren	f
Cristina	f
Laura	f
Nerea	f
Ane	f
Isabel	f
Carmen	f
Marta	f
Arantza	f
Elena	f
Maialen	f
Izaskun	f
Anna	f
Maider	f
Begoña	f
Patricia	f
Eva	f
Rosa	f
Teresa	f
Jone	f
Pilar	f
Garbiñe	f
Sara	f
Arantxa	f
Olatz	f
Irene	f
Ainara	f
Oihana	f
Aitziber	f
Lourdes	f
Susana	f
Yolanda	f
Silvia	f
Nekane	f
Edurne	f
Iratxe	f
Nagore	f
Irati	f
Victoria	f
Mercedes	f
Marina	f
Uxue	f
Esther	f
Paula	f
Beatriz	f
Mertxe	f
Julia	f
Anne	f
Angela	f
Sandra	f
Marian	f
Sonia	f
Oihane	f
Karmele	f
Eli	f
Joana	f
Maitane	f
Natalia	f
Belén	f
Helena	f
Blanca	f
Inés	f
Marie	f
Olga	f
Josune	f
Itxaso	f
Nora	f
Emma	f
Maritxu	f
Margaret	f
Zuriñe	f
Garazi	f
Marisa	f
Miriam	f
Sarah	f
Mary	f
Jessica	f
Lucía	f
Raquel	f
Naiara	f
Mónica	f
Juana	f
Virginia	f
Michelle	f
Bakartxo	f
Jennifer	f
Claudia	f
Gloria	f
Tania	f
Catherine	f
Estitxu	f
Christine	f
Aintzane	f
Marisol	f
Maribel	f
Manuela	f
Onintza	f
Ángela	f
Lorena	f
Irantzu	f
Maddi	f
Mireia	f
Lorea	f
Lara	f
Dolores	f
Bea	f
Barbara	f
Inma	f
Gemma	f
Isabelle	f
Carla	f
Eneritz	f
Diana	f
Caroline	f
Larraitz	f
Arrate	f
Susan	f
Nicole	f
Jane	f
Ruth	f
Ines	f
Margarita	f
Reyes	f
Estefanía	f
Alexandra	f
Lierni	f
Amy	f
Rita	f
Naroa	f
Judith	f
Maddalen	f
Irune	f
Elizabeth	f
Andra	f
Naomi	f
Kristina	f
Patrice	f
Jaione	f
Anita	f
Rachel	f
Elisa	f
Sofía	f
Michele	f
Kyle	f
Alazne	f
June	f
Erika	f
Nahikari	f
Belen	f
Daniele	f
Carolina	f
Alice	f
Vanessa	f
Tere	f
Petra	f
Muriel	f
Rebeka	f
Esperanza	f
Colette	f
Kelly	f
Almudena	f
Monika	f
Alaitz	f
Gabriela	f
Dilma	f
Sophie	f
Núria	f
Martine	f
Anabel	f
Charlotte	f
Claire	f
Adriana	f
Marion	f
Lurdes	f
José	m
Juan	m
Mikel	m
Jon	m
Iñaki	m
Javier	m
David	m
Carlos	m
Luis	m
Miguel	m
Jose	m
Joseba	m
Fernando	m
John	m
Pedro	m
Antonio	m
Pablo	m
Jorge	m
Unai	m
Gorka	m
Asier	m
Sergio	m
Francisco	m
Manuel	m
Iker	m
Jesús	m
Patxi	m
Alex	m
Daniel	m
Michael	m
Jean	m
Imanol	m
Ander	m
Eneko	m
Enrique	m
Roberto	m
Martin	m
Julen	m
Andoni	m
Diego	m
Eduardo	m
Alfonso	m
Koldo	m
Robert	m
Joan	m
Mohamed	m
Ricardo	m
Jordi	m
Mario	m
Ramón	m
Beñat	m
Peter	m
Ibon	m
Rafael	m
James	m
Xabi	m
Dani	m
Raúl	m
Aritz	m
Ángel	m
Víctor	m
Michel	m
Javi	m
Ignacio	m
Joxe	m
Mark	m
Rafa	m
Thomas	m
Álvaro	m
Pierre	m
Borja	m
Peio	m
Jaime	m
Alejandro	m
Santiago	m
Oier	m
Josep	m
Rubén	m
Tom	m
Gabriel	m
Angel	m
Marc	m
Alfredo	m
Richard	m
Paco	m
Pello	m
Vicente	m
Óscar	m
Andrés	m
Kevin	m
Kepa	m
Jonathan	m
Martín	m
Alain	m
Joaquín	m
Iván	m
Oscar	m
Juanjo	m
François	m
William	m
Ion	m
Ibai	m
Alexander	m
Xavier	m
Emilio	m
Albert	m
Ramon	m
Ernesto	m
Guillermo	m
Charles	m
Steve	m
Patrick	m
Adolfo	m
Nicolas	m
Marco	m
Carles	m
Ali	m
Tony	m
Rodrigo	m
Gonzalo	m
Markel	m
Philippe	m
Mariano	m
Álex	m
Adam	m
Gaizka	m
Mike	m
Txema	m
Bill	m
Fran	m
Iban	m
Félix	m
Kike	m
Jesus	m
Antton	m
Frank	m
Samuel	m
Joe	m
Joseph	m
Arturo	m
Bruno	m
Nicolás	m
Txomin	m
Karlos	m
Oskar	m
Simon	m
Joxean	m
César	m
Victor	m
Esteban	m
Gotzon	m
Oriol	m
Jack	m
Vladimir	m
Brian	m
Aimar	m
Sam	m
Bob	m
Roger	m
Federico	m
Ahmed	m
Ivan	m
Bernard	m
Max	m
Ruben	m
Julian	m
Hugo	m
Tim	m
Louis	m
Jacques	m
Marcelo	m
Omar	m
Andy	m
Jaume	m
Laurent	m
Jimmy	m
Gregorio	m
Fermin	m
Billy	m
Josetxo	m
